11111111111
10000000001
10000000001
10111111111
