NO texture/no.xpm
SO texture/so.xpm
WE texture/we.xpm
EA texture/ea.xpm
EA texture/ea.xpm

F 255,255,0255
C 225,30,255

        1111111111111111111111111
        1000000000110000000000001
        1011000001110000000000001
        1001000000000000000000001
111111111011000001110000000000001
1000000000110000011101110111111111111111111111111111111111
11110111111111011100000010001                           1
111111111111111111111111111111111111111111111111111111111
11110111111111011101010010001
11000000110101011100000010001
10000000000000001100000010001
10000000000000001101010010001
11000001110101011111011110N0111
11110111 1110101 101111010001
11111111 1111111 111111111111
