NO texture/test.xpm
SO texture/test.xpm
WE texture/test.xpm
EA texture/test.xpm

F 175,139,199
C 144,139,255

111111111111111111111111111111111111
1N0000000000000000000000000000000001
111111111111111111111111111111111101
100000000000000000000000000000000101
101111111111111111111111111111110101
101000000000000000000000000000010101
101011111111111111111111111111010101
101010000000000000000000000000010101
101011111111111111111111111111110101
101000000000000000000000000000000101
101111111111111111111111111111111101
100000000000000000000000000000000001
111111111111111111111111111111111111
