NO texture/no.xpm
SO texture/so.xpm
WE texture/we.xpm
EA texture/ea.xpm

F 220,100,0
C 225,30,0

1111111
1110011
11101N1
1111111
