NO texture/test.xpm
SO texture/test.xpm
WE texture/test.xpm
EA texture/test.xpm

F 220,100,0
C 225,30,0

1111111
1110011
1W10111
11111
