1111111
10E0001
100M101
1111111
