1111111
10E0001
100i101
1111111
