1111111
1000001
100i101
1111111
