NO texture/test.xpm
SO texture/test.xpm
WE texture/test.xpm
EA texture/test.xpm

F 220,100,0
C 225,30,0

111111111
100010001
100011001
100000001
100000001
100000001
100000001
100000001
1N0000001
111111111
