NO texture/no.xpm
SO texture/so.xpm
WE texture/we.xpm
EA texture/ea.xpm

F 220,100,0
C 225,30,0

1111111111111111111111111
1000000000000000000010001
1000000000000000000010001
1000000000N00000000010001
1000000000000000000010001
1000000000000000000010001
1000000000000000000010001
1000000000000000000010001
1000000000000000000010001
1111111111111111111111111
