NO texture/test.xpm
SO texture/test.xpm
WE texture/test.xpm
EA texture/test.xpm

F 220,100,0
C 225,30,0

1111111111
1000000001
1000000001
1000001001
1000000001
1000000001
1000000001
1E00000001
1000000001
1111111111
