
NO texture/no.xpm
SO texture/so.xpm
WE texture/we.xpm
EA texture/ea.xpm

F 255,0
C 144,139,255

111111111111111111111111111111111
1       1000000000110000000000001
1       1110000000011100000000001
1       1000000000000000000000011
111111111111000001110000000000001
100000001011000001110011100011111
11110011011100011100000010001
11110011111100011100000010001
11000000110000011100000010001
10000000000000000000000010001
100000000000000000000000N1001
1100000111000001110000111000111
11100111 1110001 10000101000111
11111111 1111111 11111111111111