NO texture/no.xpm
SO texture/so.xpm
WE texture/we.xpm
EA texture/ea.xpm

F 175,139,199
C 144,139,255

        1111111111111111111111111
        1000000000110000000000001
        1000000001110000000000001
        1000000000000000000000001
111111111111000001110000000000001
100000000011000001110011100011111
11110011111100011100000010001
11110011111100011100000010001
11000000110000011100000010001
10000000000000000000000010001
10000000000000000000000010001
11000001110000011100001110N0111
11100111 1110001 10000101000111
11111111 1111111 11111111111111

1
